人	gnin
亻	gnin
攵	ven
阝	gni
辶	tseu
镸	jian
乙	ciq
丶	ti
又	yeu
居	ciu
虫	dzon
丨	zyu
糸	sy
马	mo
鱼	ng
儿	er
卤	lu
坏	wa ua
台	the de
咸	ghae yi
么	iau mou
厂	chian
广	kuaon
宁	dzyu gnin
圣	khuaq shin
达	thi daq
适	kuaq shiq
叶	yaq yiq
荐	ji ci
蚕	thi zei-ze
猎	zhiq liaq
宀	ke
冖	ke
